############################
#_#___#____##__________##__#
#____##____##____##________#
#____@__________##____##___#
############################