#######
#_#___#
#____##
#____@#
#######